Untitled
An Interactive Fiction by Jonathan Nakagawa
Release 1 / Serial number 141022 / Inform 7 build 6L38 (I6/v6.33 lib 6/12N) SD

Chair

>io
That's not a verb I recognise.

>i
You are carrying:
  500 Orange Stock

* * *

>i
You are carrying:
  500 Orange Stock

>drop orange stock
Dropped.

>i
You are carrying nothing.

* * *

Untitled
An Interactive Fiction by Jonathan Nakagawa
Release 1 / Serial number 141022 / Inform 7 build 6L38 (I6/v6.33 lib 6/12N) SD

Chair

>i
You are carrying nothing.

* * *

Untitled
An Interactive Fiction by Jonathan Nakagawa
Release 1 / Serial number 141022 / Inform 7 build 6L38 (I6/v6.33 lib 6/12N) SD

Chair

>sell orange stock 100
sold 648 left

* * *

Untitled
An Interactive Fiction by Jonathan Nakagawa
Release 1 / Serial number 141022 / Inform 7 build 6L38 (I6/v6.33 lib 6/12N) SD

Chair

>sell orange stock
I didn't understand that sentence.

>i
You are carrying:
  Orange Stock

>sell Orange Stock
I didn't understand that sentence.

>Sell Orange Stock 352
sold 648 left

>i
You are carrying:
  Orange Stock