"Hurry up! I thought I asked you for those copies five minutes ago and this coffee is cold get me another." You have had this job for less than two days and already contimplated "acidently" pushing your Boss out a window 12 times. "Hell, Michael was a better assitant than you are and he couldn't tell the differance between a pen and pencil." Your jaw begins to ache from holding tightly clenched shut to contain the fowl stream of profanity that you would otherwise end up hurrling at your boss. Standing up from the file you've been sorting you turn to your boss and manage to say, "Alright I'm going to make copies and get your coffee i'll be back soon." His face turns and even darker shade of red as he shouts, "No! You stay here I don't want to have to wait another hour for my coffee."

BlueChipDown
An Interactive Fiction by Jonathan Nakagawa
Release 1 / Serial number 141020 / Inform 7 build 6L38 (I6/v6.33 lib 6/12N) SD

Boss's Cubical
Perhaps this room, if it can even be called a room, is the reason your Boss is constantly angry. Barely large enough for you to take a step in any direction everything is within easy arms reach. Not that there is much here an old computer sitting on a desk, a filling cabinet, and corded phone.

From day to day your Boss never seem change his appearence. He must own at least a dozen of the same set of plain clothes. Whenever he sees you his face turns a deep beetroot red and he seems to inflate.

You can also see Filling Cabinet (closed) here.

>ask boss about 1
There is no reply.

* * *

>2
"Tell me, didn't you used to have a young assistant working here?" She shrugs. "Young men these days are so unstable. He left-- who knows where he's gone? I haven't seen hair or fingernail of him for weeks."

* * *

>x
What do you want to examine?

>s
You see nothing unexpected in that direction.

>n
You can't go that way.

>e
You can't go that way.

* * *

I beg your pardon?

>w
You can't go that way.

>s
Floor One Hallway

>1
"Say, are you hiring?" you ask, as casually as you can manage. You looks you over dubiously. "I might be hiring someone, but I can't say it would necessarily be you."

* * *

>i
You are carrying:
  cabinet key

* * *

>open cabinet
(cabinet key)
It isn't something you can open.

* * *

>unlock cabinet
(with Cabinet Key)
That doesn't seem to be something you can unlock.

* * *

>s
Floor One Hallway

>e
Jonah's Cubical

>w
Floor One Hallway

>w
Floor One Elevator

>push ground floor button
Lobby
You disintrestedly drum out a tatto on the posters wooden frame waiting for the elevator's door to ding open. Finally you step out into a bustling lobby.

>e
Lobby Elevator

>w
Lobby

>w
Car

>e
Lobby

* * *

>push ground floor button
Lobby
You disintrestedly drum out a tatto on the posters wooden frame waiting for the elevator's door to ding open. Finally you step out into a bustling lobby.

>w
Car
You can see Driver here.

>talk to driver
Driver doesn't reply.

SEC

* * *

>w
Floor One Elevator

>push ground button
Lobby
You disintrestedly drum out a tatto on the posters wooden frame waiting for the elevator's door to ding open. Finally you step out into a bustling lobby.

>w
Car
You can see Driver here.

>talk to driver
Driver doesn't reply.

SEC
"Where do you want to go sir?" 

 "Take me to SEC" 

 "Right away sir."

>n
Taxi
You can see Taxi Driver here.

* * *

>talk to boss
You could say: 
[1]: hello how are you?

* * *

>0
"Say, are you hiring?" you ask, as casually as you can manage. You looks you over dubiously. "I might be hiring someone, but I can't say it would necessarily be you."

* * *

>unlock filling cabinet
(with Cabinet Key)
You unlock Filling Cabinet.

* * *

>1
"Why in the world would you need that? And why should I trust you with it?"

>3
No such option is available.

* * *

>1
"Why in the world would you need that? And why should I trust you with it?"

>1
No such option is available.

* * *

>1
"Why in the world would you need that? And why should I trust you with it?"

>4
No such option is available.

* * *

>1
"Why in the world would you need that? And why should I trust you with it?"

>2
No such option is available.

* * *

>1
"Why in the world would you need that? And why should I trust you with it?"

>ask boss about 1
There is no reply.

>2
"Tell me, didn't you used to have a young assistant working here?" She shrugs. "Young men these days are so unstable. He left-- who knows where he's gone? I haven't seen hair or fingernail of him for weeks."