"Hurry up! I thought I asked you for those copies five minutes ago and this coffee is cold get me another." You have had this job for less than two days and already contimplated "acidently" pushing your Boss out a window 12 times. "Hell, Michael was a better assitant than you are and he couldn't tell the differance between a pen and pencil." Your jaw begins to ache from holding tightly clenched shut to contain the fowl stream of profanity that you would otherwise end up hurrling at your boss. Standing up from the file you've been sorting you turn to your boss and manage to say, "Alright I'm going to make copies and get your coffee i'll be back soon." His face turns and even darker shade of red as he shouts, "No! You stay here I don't want to have to wait another hour for my coffee."

BlueChipDown
An Interactive Fiction by Jonathan Nakagawa
Release 1 / Serial number 141019 / Inform 7 build 6L38 (I6/v6.33 lib 6/12N) SD

Boss's Cubical
Perhaps this room, if it can even be called a room, is the reason your Boss is constantly angry. Barely large enough for you to take a step in any direction everything is within easy arms reach. Not that there is much here an old computer sitting on a desk, a filling cabinet, and corded phone.

From day to day your Boss never seem change his appearence. He must own at least a dozen of the same set of plain clothes. Whenever he sees you his face turns a deep beetroot red and he seems to inflate.

You can also see Filling Cabinet (empty) here.

>s
Floor One Hallway

* * *

>e
Jonah's Cubical

>n
You can't go that way.

* * *

>e
You can't go that way.

>n
You can't go that way.

>w
Floor One Hallway

* * *

>w
Floor One Elevator

>push ground floor button
Lobby

>e
Lobby Elevator

>l
Lobby Elevator

* * *

>e
Lobby

>w
Car

* * *

>w
Floor One Elevator

>push the ground floor button
Lobby
You disintrestedly drum out a tatto on the posters wooden frame waiting for the elevator's door to ding open. Finally you step out into a bustling lobby.

>e
Lobby Elevator

>push the Floor two button
Floor Two Hallway
You disintrestedly drum out a tatto on the posters wooden frame waiting for the elevator's door to ding open. Finally you step out into a quiet hallway flanked by offices.

>e
You can't go that way.

>w
You can't go that way.

>n
You can't go that way.

>s
You can't go that way.