"Hurry up! I thought I asked you for those copies five minutes ago." You have had this internship a Merrill Lynch, one of the largest investment companies in the world, for less than two days and already contemplated "accidently" pushing your Boss out a window 12 times. Standing up from the file you've been sorting you turn to your boss and manage to say, "Alright I'm going to make copies just give me ten seconds." His face turns and even darker shade of red as he shouts, "No! You stay here I don't want to have to wait another hour." and leaves the room.

BlueChipDown
An Interactive Fiction by Jonathan Nakagawa
Release 1 / Serial number 141028 / Inform 7 build 6L38 (I6/v6.33 lib 6/12N) SD

Boss's Cubical
 Perhaps this room, if it can even be called a room, is the reason your Boss is constantly angry. Barely large enough for you to take a step in any direction everything is within easy arms reach. Not that there is much here an old computer sitting on a desk, a filling cabinet, and corded phone. The computer is insistently beeping.

>x filling cabinet
You see nothing special about Filling Cabinet.

>x cabinet key
This is where your Boss keeps all his records. Perhaps there may be something incriminating inside but you Boss has the key.

* * *

>sell orange stock 1
Now you have 99 Orange stock and 200 dollars.

>purchase orange stock 1
Now you have 100 Orange stock and 0 dollars.

>ABCD
*** Run-time problem P31: Attempt to use a property of the 'nothing' non-object: property orange-price

* * *

>sell orange stock 100
Now you have 0 Orange stock and 20000 dollars.

>sell backward stock 100
Now you have 0 backward stock and 35000 dollars.

>sell redwood stock 20
Now you have 0 redwood stock and 37000 dollars.

The computer stops its insistent bleeping just as a voice booms out from a hidden speaker, "All employees come directly to the meeting room." You recall the meeting room is south out of your office, west through the hallway into the elevator, down to the ground floor, and finally south from the lobby.

>s
Floor One Hallway
To the north is your Boss's cubical, to the east is Phillip's Cubical, and to the east if the elevator.

>e
Phillip's Cubical
Phillip's cubical while still small is significantly larger than yours. His computer is slightly less clunky than yours and has a stapler sitting next to it. Otherwise his office is mostly empty.

>push floor two
You can't see any such thing.

>push floor two button
You can't see any such thing.

>w
Floor One Hallway
To the north is your Boss's cubical, to the east is Phillip's Cubical, and to the east if the elevator.

>w
Floor One Elevator
The company elevator is lined by decorative wodden panneling. A poster is a fixed to the wall directly across from the door and three buttons are just to the right of the door. They read Ground Floor, Floor One, and Floor Two. The exit is to the west.

>push floor two button
You disinterestedly drum out a tatto on the posters wooden frame waiting for the elevator's door to ding open. Finally you step out into a expansive reception room.

Reception
This reception room is more lavish than any other portion of the building you have seen. Behind a marble desk sits an attendant. To the west is Jonathan Office.

>w
(first opening CEO Door)
It seems to be locked.

* * *

>e
Phillip's Cubical
Phillip's cubical while still small is significantly larger than yours. His computer is slightly less clunky than yours and has a stapler sitting next to it. Otherwise his office is mostly empty.

>push ground floor button
You can't see any such thing.

>w
Floor One Hallway
To the north is your Boss's cubical, to the east is Phillip's Cubical, and to the east if the elevator.

>w
Floor One Elevator
The company elevator is lined by decorative wooden paneling. A poster is a fixed to the wall directly across from the door and three buttons are just to the right of the door. They read Ground Floor, Floor One, and Floor Two. The exit is to the west.

>push ground floor button
You disinterestedly drum out a tattoo on the posters wooden frame waiting for the elevator's door to ding open. Finally you step out into a bustling lobby.

Lobby
The lobby is bustling with activity. Dozens of former employees are being escorted off company ground carrying their supplies in little cardboard boxes. To the south is a meeting room and north is a cafe.

>s
You are one of the last employees to file into the Meeting room. It's jam-packed containing more than 30 employees. Jonathan the senior official in this branch of Merrill Lynch laboriously clambers on top of the table to address everyone assembled. "I think most of you know why we are here but in case you've been asleep for the past five hours I'll recap. The DOW just dropped 250 points in one day and our analysts predict it isn't going to get better for a very long time. Therefore, Merrill Lynch will not be able to keep all of you. He begins to rattle off a list of names and finally employee number 27?" Your Boss perks up and says, "That would be me sir." "Ah of course well you can stay. Everyone else has 3 hours to pack and leave." You can't afford to lose this job. It's the only thing paying your rent there must be some way to take your Boss's place after all it was you who saved his stocks. Perhaps there might be something in his office.

Meeting Room
The room is dominated by a by a large glass table placed squarely in the center of the room. In the front of the room is a projector screen and back to the north is the lobby.

>x newspaper
The newspaper is almost entirely devoted to the stock market dropping. The second page reads, "This is a not a minor event that's going to go away in a night. I expect orange's stock to keep dropping for the foreseeable future."

>n
Lobby
The lobby is bustling with activity. Dozens of former employees are being escorted off company ground carrying their supplies in little cardboard boxes. To the south is a meeting room and north is a cafe.

>e
Lobby Elevator
The company elevator is lined by decorative wooden paneling. A poster is a fixed to the wall directly across from the door and three buttons are just to the right of the door. They read Ground Floor, Floor One, and Floor Two. The exit is to the west.

>push floor one
You disinterestedly drum out a tattoo on the posters wooden frame waiting for the elevator's door to ding open. Finally you step out into a endless sea of cubicles.

Floor One Hallway
To the north is your Boss's cubical, to the east is Phillip's Cubical, and to the east if the elevator.

>n
Boss's Cubical
 Perhaps this room, if it can even be called a room, is the reason your Boss is constantly angry. Barely large enough for you to take a step in any direction everything is within easy arms reach. Not that there is much here an old computer sitting on a desk, a filling cabinet, and corded phone. Your Boss is standing in the corner.

>i
You are carrying:
  Orange stock x 0
  backward stock x 0
  Redwood stock x 0

>buy backward stock 200
Now you have 200 backward stock and 7000 dollars.

>buy backward stock 100
You don't have enough money.

>buy backward stock 10
Now you have 210 backward stock and 5500 dollars.

>buy backward stock 10
Now you have 220 backward stock and 4000 dollars.

>buy backward stock 10
Now you have 230 backward stock and 2500 dollars.

>buy backward stock 10
Now you have 240 backward stock and 1000 dollars.

>buy backward stock 10
You don't have enough money.

>buy backward stock 15
You don't have enough money.

>buy backward stock 5
Now you have 245 backward stock and 250 dollars.

>buy backward stock 1
Now you have 246 backward stock and 100 dollars.

>buy backward stock 1
You don't have enough money.

>buy redwood stock 1
Now you have 1 redwood stock and 0 dollars.

>i
You are carrying:
  Orange stock x 0
  backward stock x 246
  Redwood stock x 1

>go home
Another day ends as you lock in your final trades. You arrive back in the lobby after another long day.

Lobby
The lobby is bustling with activity. Dozens of former employees are being escorted off company ground carrying their supplies in little cardboard boxes. To the south is a meeting room and north is a cafe.

>n
Cafe
This is where the less successful financial investors tend to meet their clients. 

You can see Client here.

>talk to clinet
You can't see any such thing.

>talk to client
You could say: 
[1]"Hello. How are you doing today?"
[2]"So why did you call me?"

>2
"So why did you call me?" you ask. "Ah, someone who gets straight to the point I like that. I want to know what you are planning to do with my money."

>talk to client
You could say: 
[3]"When the stock market is in turmoil like it is now you have the chance to make much more than if it were stable. I have acsess to numerous charts ands projections created by our best analysts. Have no fear I will keep your money safe."
[4]"I'm going to make more of it."

>4
"I'm going to make more of it." you say. "I like that" she responds. "I think you are going to make a good broker so I'll give you some advice. One of my other brokers tells me that redwood is going to do well soon. Well that's all for now." She stands up and exits.

>s
Lobby
The lobby is bustling with activity. Dozens of former employees are being escorted off company ground carrying their supplies in little cardboard boxes. To the south is a meeting room and north is a cafe.

>e
Lobby Elevator
The company elevator is lined by decorative wooden paneling. A poster is a fixed to the wall directly across from the door and three buttons are just to the right of the door. They read Ground Floor, Floor One, and Floor Two. The exit is to the west.

* * *

>push floor one
You disinterestedly drum out a tattoo on the posters wooden frame waiting for the elevator's door to ding open. Finally you step out into a endless sea of cubicles.

Floor One Hallway
To the north is your Boss's cubical, to the east is Phillip's Cubical, and to the east if the elevator.

>i
You are carrying:
  Orange stock x 0
  backward stock x 246
  Redwood stock x 1

* * *

>i
You are carrying:
  Orange stock x 0
  backward stock x 246
  Redwood stock x 1

>buy orange stock
Nothing is on sale.

* * *

>i
You are carrying:
  Orange stock x 0
  backward stock x 246
  Redwood stock x 1

>n
Boss's Cubical
Perhaps this room, if it can even be called a room, is the reason your Boss is constantly angry. Barely large enough for you to take a step in any direction everything is within easy arms reach. Not that there is much here an old computer sitting on a desk, a filling cabinet, and corded phone.

>sell backward stock 246
Now you have 0 backward stock and 49200 dollars.

>buy redwood stock 300
Now you have 301 redwood stock and 16200 dollars.

>buy redwood stock 100
Now you have 401 redwood stock and 5200 dollars.

>buy redwood stock 10
Now you have 411 redwood stock and 4100 dollars.

>buy redwood stock 10
Now you have 421 redwood stock and 3000 dollars.

>buy redwood stock 10
Now you have 431 redwood stock and 1900 dollars.

I beg your pardon?

I beg your pardon?

>buy redwood stock 10
Now you have 441 redwood stock and 800 dollars.

>buy redwood stock 10
You don't have enough money.

>buy redwood stock 1
Now you have 442 redwood stock and 690 dollars.

>buy redwood stock 1
Now you have 443 redwood stock and 580 dollars.

>buy redwood stock 1
Now you have 444 redwood stock and 470 dollars.

>buy redwood stock 1
Now you have 445 redwood stock and 360 dollars.

>buy redwood stock 1
Now you have 446 redwood stock and 250 dollars.

>buy redwood stock 1
Now you have 447 redwood stock and 140 dollars.

>buy redwood stock 1
Now you have 448 redwood stock and 30 dollars.

>buy redwood stock 1
You don't have enough money.

>i
You are carrying:
  Orange stock x 0
  backward stock x 0
  Redwood stock x 448

>go home
Another day ends as you lock in your final trades. You arrive back in the lobby after another long day.

Lobby
The lobby is bustling with activity. Dozens of former employees are being escorted off company ground carrying their supplies in little cardboard boxes. To the south is a meeting room and north is a cafe.

>e
Lobby Elevator
The company elevator is lined by decorative wooden paneling. A poster is a fixed to the wall directly across from the door and three buttons are just to the right of the door. They read Ground Floor, Floor One, and Floor Two. The exit is to the west.

>push floor one button
You disinterestedly drum out a tattoo on the posters wooden frame waiting for the elevator's door to ding open. Finally you step out into a endless sea of cubicles.

Floor One Hallway
To the north is your Boss's cubical, to the east is Phillip's Cubical, and to the east if the elevator.

>n
Boss's Cubical
Perhaps this room, if it can even be called a room, is the reason your Boss is constantly angry. Barely large enough for you to take a step in any direction everything is within easy arms reach. Not that there is much here an old computer sitting on a desk, a filling cabinet, and corded phone.

You can see Call Card here.

>x call card
Financial Analyst for Hire 
 Contact us at "123-4567"

>i
You are carrying:
  Orange stock x 0
  backward stock x 0
  Redwood stock x 448

>sell redwood stock 2
Now you have 446 redwood stock and 310 dollars.

>sell redwood stock 2
Now you have 444 redwood stock and 590 dollars.

>sell redwood stock 2
Now you have 442 redwood stock and 870 dollars.

>sell orange stock 100
You don't have that many stock to sell. You have 0 Orange stock.

>sell orange stock 100
You don't have that many stock to sell. You have 0 Orange stock.

>sell redwood stock 2
Now you have 440 redwood stock and 1150 dollars.

>sell redwood stock 2
Now you have 438 redwood stock and 1430 dollars.

>sell redwood stock 2
Now you have 436 redwood stock and 1710 dollars.

>sell redwood stock 2
Now you have 434 redwood stock and 1990 dollars.

>sell redwood stock 5
Now you have 429 redwood stock and 2690 dollars.

>sell redwood stock 5
Now you have 424 redwood stock and 3390 dollars.

>sell redwood stock 5
Now you have 419 redwood stock and 4090 dollars.

>sell redwood stock 5
Now you have 414 redwood stock and 4790 dollars.

>sell redwood stock 1
Now you have 413 redwood stock and 4930 dollars.

>sell redwood stock 1
Now you have 412 redwood stock and 5070 dollars.

>i
You are carrying:
  Orange stock x 0
  backward stock x 0
  Redwood stock x 412

>call 123-4567
"Hello are you a financial analyst?" you ask. ""That is correct. For the small fee of 5,000 dollars I can give you my prediction. 
[1]"Ok"
[2]"No thanks"

>1
"Ok, I'll do it." you say. "My charts predict a rise in the worth of redwood." he responds.

>talk to boss
You can't see any such thing.

>i
You are carrying:
  Orange stock x 0
  backward stock x 0
  Redwood stock x 412

>go home
Another day ends as you lock in your final trades. You arrive back in the lobby after another long day.

Lobby
The lobby is bustling with activity. Dozens of former employees are being escorted off company ground carrying their supplies in little cardboard boxes. To the south is a meeting room and north is a cafe.

* * *

>n
Boss's Cubical
Perhaps this room, if it can even be called a room, is the reason your Boss is constantly angry. Barely large enough for you to take a step in any direction everything is within easy arms reach. Not that there is much here an old computer sitting on a desk, a filling cabinet, and corded phone.

You can see Call Card here.

>i
You are carrying:
  Orange stock x 0
  backward stock x 0
  Redwood stock x 412

>sell redwood stock 412
Now you have 0 redwood stock and 65990 dollars.

>buy orange stock 300
Now you have 300 Orange stock and 38990 dollars.

>buy orange stock 100
Now you have 400 Orange stock and 29990 dollars.

>buy orange stock 100
Now you have 500 Orange stock and 20990 dollars.

>buy orange stock 100
Now you have 600 Orange stock and 11990 dollars.

>buy orange stock 100
Now you have 700 Orange stock and 2990 dollars.

>buy orange stock 100
You don't have enough money.

>buy orange stock 10
Now you have 710 Orange stock and 2090 dollars.

>buy orange stock 10
Now you have 720 Orange stock and 1190 dollars.

>buy orange stock 10
Now you have 730 Orange stock and 290 dollars.

* * *

>buy orange stock 1
Now you have 731 Orange stock and 200 dollars.

>buy orange stock 1
Now you have 732 Orange stock and 110 dollars.

>buy orange stock 1
Now you have 733 Orange stock and 20 dollars.

>i
You are carrying:
  Orange stock x 733
  backward stock x 0
  Redwood stock x 0

>go home
Another day ends as you lock in your final trades. You arrive back in the lobby after another long day.

Lobby
The lobby is bustling with activity. Dozens of former employees are being escorted off company ground carrying their supplies in little cardboard boxes. To the south is a meeting room and north is a cafe.

>go home
Another day ends as you lock in your final trades. You arrive back in the lobby after another long day.

>undo
Lobby
[Previous turn undone.]

>e
Lobby Elevator
The company elevator is lined by decorative wooden paneling. A poster is a fixed to the wall directly across from the door and three buttons are just to the right of the door. They read Ground Floor, Floor One, and Floor Two. The exit is to the west.

* * *

>push floor one button
You disinterestedly drum out a tattoo on the posters wooden frame waiting for the elevator's door to ding open. Finally you step out into a endless sea of cubicles.

Floor One Hallway
To the north is your Boss's cubical, to the east is Phillip's Cubical, and to the east if the elevator.

>n
As you enter your cubical your phone begins to ring.

>answer phone
"Who is this?" you ask. "It's Jonathan again. It has been four days. I would like you to try sell all the stocks you own so that I can asses your performance." he responds

>i
You are carrying:
  Orange stock x 733
  backward stock x 0
  Redwood stock x 0

>sell orange stock 733
Now you have 0 Orange stock and 249240 dollars.

You phone begins to ring again.

>answer phone
"Who is this?" you ask. "It's Jonathan again. I would like to speak to you. Come to my office on the second floor." he says.

>s
Floor One Hallway
To the north is your Boss's cubical, to the east is Phillip's Cubical, and to the east if the elevator.

* * *

>e
Phillip's Cubical
Phillip's cubical while still small is significantly larger than yours. His computer is slightly less clunky than yours and has a stapler sitting next to it. Otherwise his office is mostly empty.

>undo
Floor One Hallway
[Previous turn undone.]

>undo
Boss's Cubical
[Previous turn undone.]

>undo
Boss's Cubical
[Previous turn undone.]

>undo
Floor One Hallway
[Previous turn undone.]

>undo
Lobby Elevator
[Previous turn undone.]

>undo
The use of "undo" is forbidden in this game.

>e
You can't go that way.

I beg your pardon?

>w
Lobby
The lobby is bustling with activity. Dozens of former employees are being escorted off company ground carrying their supplies in little cardboard boxes. To the south is a meeting room and north is a cafe.

>e
Lobby Elevator
The company elevator is lined by decorative wooden paneling. A poster is a fixed to the wall directly across from the door and three buttons are just to the right of the door. They read Ground Floor, Floor One, and Floor Two. The exit is to the west.

* * *

>s
Floor One Hallway
To the north is your Boss's cubical, to the east is Phillip's Cubical, and to the east if the elevator.

>w
Floor One Elevator
The company elevator is lined by decorative wooden paneling. A poster is a fixed to the wall directly across from the door and three buttons are just to the right of the door. They read Ground Floor, Floor One, and Floor Two. The exit is to the west.

>push floor  two button
You disinterestedly drum out a tattoo on the posters wooden frame waiting for the elevator's door to ding open. Finally you step out into a expansive reception room.

Reception
This reception room is more lavish than any other portion of the building you have seen. Behind a marble desk sits an attendant. To the west is Jonathan Office.

>talk to attendant
You could say: 
[1]"May I speak Jonathan?"
[2]"Hello, how has your day been?"

>2
"Hello, how has your day been?" you ask. "Not great dear. Jonathan in recent years hasn't been very kind to me. And I fear that after these recent firings I'm going to be worked harder than ever."

>talk to attendant
You could say: [5]"Well perhaps he has grown complacent and it's time for him to be replaced."

>5
"Well perhaps he has grown complacent and it's time for him to be replaced." you say. "You know maybe you're right. I think you would make a much better Boss's than him. Take this card it has Jonathan's password on it see what you can do with that." Just then Jonathan exits his office saying, "I'll be back in a second. I just need to use the bathroom for a second."

>i
You are carrying:
  Password Card
  Orange stock x 0
  backward stock x 0
  Redwood stock x 0

>l
Reception
This reception room is more lavish than any other portion of the building you have seen. Behind a marble desk sits an attendant. To the west is Jonathan Office.

>w
(first opening CEO Door)

CEO Office
 Jonathan posses a beautiful office overlooking a stunning view. In the middle of the room is a wooden desk with a computer sitting on top of it.

>x password card
The card reads, "Jonathan is the best"

>type jonathan is the best
The computer dings and the lock screen disappears revealing the folder Pictures and his Imgur account. The imgur account reads "Put a photo in imgur to upload it."

>open folder
That's already open.

>x folder
This is where Jonathan keeps his Photos

In Pictures Folder is Obscene Photos.

>take obscene photos
Taken.

>put obscene photos in imgur
You put Obscene Photos into Imgur.

Just as you upload the photos and log out Jonathan re-enters the room.

>talk to jonathan
Just as you upload the photos and log out Jonathan re-enters the room.

    *** "Hello sir." you say. "It's nice to see you. I have been looking at your progress over the past four days. I must say you have done very well. I'm impressed. I think you will make a fine broker better than we could hire right now. We are keeping you on." Just as Jonathan finished talking his cellphone started to ring. "Excuse me for a moment. Hello. Yes this is Jonathan. What! No! I never did that! Here he is." He hands the phone to you. "Hello I'm Andrew head of Merrill Lynch's Board of Directors. Jonathan uploaded some obscene photos and the media are having field day. So he is going to be fired to save face. We would have appointed you but another broker Philip has out performed you." ***

Would you like to RESTART, RESTORE a saved game, QUIT or UNDO the last command?

* * *

>i
You are carrying:
  Orange stock x 100
  backward stock x 100
  Redwood stock x 20

>sell orange stock 100
Now you have 0 Orange stock and 20000 dollars.

* * *

>sell backward stock 100
Now you have 0 backward stock and 35000 dollars.

>sell redwood stock 20
Now you have 0 redwood stock and 37000 dollars.

The computer stops its insistant bleeping just as a voice booms out from a hidden speaker, "All employees come directly to the meeting room." You recall the meeting room is south out of your office, west through the hallway into the elevator, down to the ground floor, and finally south from the lobby.

>s
Floor One Hallway

>w
Floor One Elevator
The company elevator is lined by decorative wodden panneling. A poster is a fixed to the wall directly across from the door and three buttons are just to the right of the door. They read Ground Floor, Floor One, and Floor Two. The exit is to the west.

>push ground floor button
You disinterestedly drum out a tatto on the posters wooden frame waiting for the elevator's door to ding open. Finally you step out into a bustling lobby.

Lobby
The lobby is bustling with activity. Dozens of former employees are being escorted off company ground carring their supplies in little cardboard boxes.

>s
You are one of the last employees to file into the Meeting room. It's jampacked containing more than 30 employees. Jonathan the senior offical in this branch of Merrill Lynch laboriously clambors on top of the table to adress everyone assembled. "I think most of you know why we are here but in case you've been asleep for the past five hours I'll recap. The DOW just droped 250 points in one day and our analyists predict it isn't going to get better for a very long time. Therefore, merrill Lynch will not be able to keep all of you. He begins to rattle off a list of names and and fianlly employee number 27?" Your Boss perks up and says, "That would be me sir." "Ah of course well you can stay. Everyone else has 3 hours to pack and leave." You can't afford to lose this job. It's the only thing paying your rent there must be some way to take your Boss's place after all it was you who saved his stocks. Perhapse there might be something in his office.

Meeting Room
The room is dominated by a by a large glass table placed squarely in the center of the room. In the front of the room is a projector screen and back to the north is the lobby.

>x table
On top of the table is today's newspaper.

>x today's newspaper
The newspaper is almost entirely devoted to the stock market dropping. The second page reads, "This is a not a minor event that's going to go away in a night. I expect orange's stock to keep dropping for the forseeable future."

>n
Lobby
The lobby is bustling with activity. Dozens of former employees are being escorted off company ground carring their supplies in little cardboard boxes.

>e
Lobby Elevator
The company elevator is lined by decorative wodden panneling. A poster is a fixed to the wall directly across from the door and three buttons are just to the right of the door. They read Ground Floor, Floor One, and Floor Two. The exit is to the west.

>w
Lobby
The lobby is bustling with activity. Dozens of former employees are being escorted off company ground carring their supplies in little cardboard boxes.

>w
You can't go that way.

>e
Lobby Elevator
The company elevator is lined by decorative wodden panneling. A poster is a fixed to the wall directly across from the door and three buttons are just to the right of the door. They read Ground Floor, Floor One, and Floor Two. The exit is to the west.

* * *

>w
Lobby
The lobby is bustling with activity. Dozens of former employees are being escorted off company ground carring their supplies in little cardboard boxes.

>n
Cafe
This is where the less succsessful financial investors tend to meet their clients.

>s
Lobby
The lobby is bustling with activity. Dozens of former employees are being escorted off company ground carring their supplies in little cardboard boxes.

>e
Lobby Elevator
The company elevator is lined by decorative wodden panneling. A poster is a fixed to the wall directly across from the door and three buttons are just to the right of the door. They read Ground Floor, Floor One, and Floor Two. The exit is to the west.

>push floor one
You disinterestedly drum out a tatto on the posters wooden frame waiting for the elevator's door to ding open. Finally you step out into a endless sea of cubicals.

Floor One Hallway

>n
Boss's Cubical
 Perhaps this room, if it can even be called a room, is the reason your Boss is constantly angry. Barely large enough for you to take a step in any direction everything is within easy arms reach. Not that there is much here an old computer sitting on a desk, a filling cabinet, and corded phone.

>s
Floor One Hallway

* * *

>w
Floor One Elevator
The company elevator is lined by decorative wodden panneling. A poster is a fixed to the wall directly across from the door and three buttons are just to the right of the door. They read Ground Floor, Floor One, and Floor Two. The exit is to the west.

>push ground
You disinterestedly drum out a tatto on the posters wooden frame waiting for the elevator's door to ding open. Finally you step out into a bustling lobby.

Lobby
The lobby is bustling with activity. Dozens of former employees are being escorted off company ground carring their supplies in little cardboard boxes.

>s
Meeting Room
The room is dominated by a by a large glass table placed squarely in the center of the room. In the front of the room is a projector screen and back to the north is the lobby.

>talk to boss
You can't see any such thing.

* * *

>n
Lobby
The lobby is bustling with activity. Dozens of former employees are being escorted off company ground carring their supplies in little cardboard boxes.

>w
You can't go that way.

* * *

>n
Boss's Cubical
 Perhaps this room, if it can even be called a room, is the reason your Boss is constantly angry. Barely large enough for you to take a step in any direction everything is within easy arms reach. Not that there is much here an old computer sitting on a desk, a filling cabinet, and corded phone.

>talk to boss
You could say: 
[1]"Could I have the key for the cabinet?"

>1
"Could I have the key for the cabinet?" you ask. "Why should I give that?" your Boss responds.

>talk to boss
You could say: [2]"Because I said so and thats the only reason you should need!"
[3]"I'm going to write one final report on how you saved your client's funds."

>2
"Because I said so and thats the only reason you should need!" you say. "Get out" your Boss screams.

    *** You are fired. ***

Would you like to RESTART, RESTORE a saved game, QUIT or UNDO the last command?

>undo
Boss's Cubical
[Previous turn undone.]

>talk to boss
You could say: [2]"Because I said so and thats the only reason you should need!"
[3]"I'm going to write one final report on how you saved your client's funds."

>3
"I'm going to write one final report on how you saved your client's funds." you say. "Well... Alright." he responds handing you the key.

>unlock cabinet
What do you want to unlock Cabinet Key with?

>l
Boss's Cubical
 Perhaps this room, if it can even be called a room, is the reason your Boss is constantly angry. Barely large enough for you to take a step in any direction everything is within easy arms reach. Not that there is much here an old computer sitting on a desk, a filling cabinet, and corded phone.

>unlock filling cabinet
What do you want to unlock Filling Cabinet with?

>cabinet key
You unlock Filling Cabinet.

>opne filling cabinet
That's not a verb I recognise.

>open filling cabinet
You open Filling Cabinet, revealing nothing.

>x notes
You knew your Boss would be to lazy to cover his tracks. Scattered throughout the various files are notes from conversations with the employes of numerous companies talking about products before they had been publicly announced. These are most definitely illegal and more than enough to get your Boss arrested but maybe there won't be a need for that perhaps you should talk to him.

>take notes
Taken.

>x notes
You knew your Boss would be to lazy to cover his tracks. Scattered throughout the various files are notes from conversations with the employes of numerous companies talking about products before they had been publicly announced. These are most definitely illegal and more than enough to get your Boss arrested but maybe there won't be a need for that perhaps you should talk to him.

>talk to boss
You could say: [4]"Hey, Boss look at this!"

>4
"Hey, Boss look at this!" you say gesturing with the notes. "Give those to me!" he shouts. "No. I'm not taking any more orders from you. Things go my way now. So this is what's going to happen. You are going to go to Jonathan and say that for personal reasons you have to resign." "Never." he spits. "Or would you prefer I go to the cops with this" you respond. "Fine." he said turning to leave. A few minutes later your phone begins to ring.

* * *

>talk to boss
You can't see any such thing.

* * *

>l
Boss's Cubical
 Perhaps this room, if it can even be called a room, is the reason your Boss is constantly angry. Barely large enough for you to take a step in any direction everything is within easy arms reach. Not that there is much here an old computer sitting on a desk, a filling cabinet, and corded phone.

>i
You are carrying:
  Notes
  Cabinet Key
  Orange stock x 0
  backward stock x 0
  Redwood stock x 0

>answer phone
"Hello this is Jonathan. I understand that you are an intern at our company. Your former Boss just resigned and you are the one who best knows his clients and investments. So we are going to keep you on for five days in order to find a more sutiable replacement. Just try to keep your client's satisfied." Five days. You have five days to prove your worth to the company and stay on the payroll. After you have made the stock trades you want to for the day write "Go home" to advance to the next day. Some of the stock prices will change over the night.

>purchase backward stock 100
Now you have 100 backward stock and 22000 dollars.

>purchase backward stock 500
You don't have enought money.

>purchase backward stock 250
You don't have enought money.

>purchase backward stock 200
You don't have enought money.

>purchase backward stock 100
You don't have enought money.

>i
You are carrying:
  Cabinet Key
  Notes
  Orange stock x 0
  backward stock x 2200
  Redwood stock x 0

>x money
You can't see any such thing.

>x computer
The computer is currently displaying your Boss's stock portofolio. It mainly consists of three stocks Orange, RedWood, and Backward. To your shock and dismay you realize that over the course of the last 10 minutes your Boss's portofolio has lost 10 percent equating to almost 13 million dollars. And the stocks" value are still plumiting. You'll have to act fast to save your clients. You try to remember how you Boss sold stocks. You think that he just typed sell or purchase, the stocks name, and the number of shares to buy or sell.

* * *

>x coded phone
You can't see any such thing.

>x corded phon
I only understood you as far as wanting to examine Corded Phone.

>x corded phone
The phone is currently dormant with no messages and there isn't anyone you really want to call right now.

* * *

>buy orange stock 10
You don't have enought money.

>i
You are carrying:
  Orange stock x 100
  backward stock x 100
  Redwood stock x 20

* * *

>x player
You can't see any such thing.

>x filling cabinet
You see nothing special about Filling Cabinet.

>s
You can't leave yet you need to first see what's up with the computer.

>sell orange stock 100
Now you have 0 Orange stock and 20000 dollars.

* * *

>sell backward stock 100
Now you have 0 backward stock and 35000 dollars.

>sell redwood stock 20
Now you have 0 redwood stock and 37000 dollars.

The computer stops its insistant bleeping. Thank hevans that you managed to sell everything before they tanked any more. A voice booms out from a hidden speaker, "All employees come directly to the meeting room." You think you get to the meeting room by going south out of your office, west through the hallway into the elevator, down to the ground floor, and finally south from the lobby.

>s
Floor One Hallway

>e
Philip's Cubical
Philip's cubical while still small is significantly larger than yours. His computer is slightly less clunky than yours and has a stapler sitting next to it. Otherwise his office is mostly empty.

You can see Stapler here.

>x stapler
test

* * *

>x filling capinet
I only understood you as far as wanting to examine Filling Cabinet.

>x filling cabinet
This is where your Boss keeps all his records. Perhaps there may be something incriminating inside but you Boss has the key.

* * *

>x me
 After getting out of college strapped to cripling debt you couldn't afford much more than a couple second hand dress shirts and an imitation watch.

* * *

>x desk
Made of plastic the desk is rather sparsely deccorated only having a computer and phone sitting on top of it.

>x phone
The phone is currently dormant with no messages and there isn't anyone you really want to call right now.

>x computer
The computer is currently displaying your Boss's stock portofolio. It mainly consists of three stocks Orange, RedWood, and Backward. To your shock and dismay you realize that over the course of the last 10 minutes your Boss's portofolio has lost 10 percent equating to almost 13 million dollars. And the stocks" value are still plumiting. You'll have to act fast to save your clients. You try to remember how you Boss sold stocks. You think that he just typed sell or purchase, the stocks name, and the number of shares to buy or sell.

* * *

>x boss
You can't see any such thing.

>x desk
You can't see any such thing.

>x filling cabinet
You see nothing special about Filling Cabinet.

>x phone
You see nothing special about Corded Phone.

>x computer
The computer is currently displaying your Boss's stock portofolio. It mainly consists of three stocks Orange, RedWood, and Backward. To your shock and dismay you realize that over the course of the last 10 minutes your Boss's portofolio has lost 10 percent equating to almost 13 million dollars. And the stocks" value are still plumiting. You'll have to act fast to save your clients. You try to remember how you Boss sold stocks. You think that he just typed sell or purchase, the stocks name, and the number of shares to buy or sell.

>take desk
You can't see any such thing.

>take phone
That's hardly portable.

>take computer
That's hardly portable.

>open filling cabinet
It seems to be locked.

>open desk
You can't see any such thing.

>l
Boss's Cubical
 Perhaps this room, if it can even be called a room, is the reason your Boss is constantly angry. Barely large enough for you to take a step in any direction everything is within easy arms reach. Not that there is much here an old computer sitting on a desk, a filling cabinet, and corded phone. The computer is insistantly beeping. 

From day to day your Boss never seem change his appearence. He must own at least a dozen of the same set of plain clothes. Whenever he sees you his face turns a deep beetroot red and he seems to inflate.

>talk to boss
You could say:

>the stocks are plummeting
That's not a verb I recognise.

>x computer
The computer is currently displaying your Boss's stock portofolio. It mainly consists of three stocks Orange, RedWood, and Backward. To your shock and dismay you realize that over the course of the last 10 minutes your Boss's portofolio has lost 10 percent equating to almost 13 million dollars. And the stocks" value are still plumiting. You'll have to act fast to save your clients. You try to remember how you Boss sold stocks. You think that he just typed sell or purchase, the stocks name, and the number of shares to buy or sell.

>x orange
Stock that you own that you can sell any number of. Type "sell orange stock" followed by the number you want to sell or "puchase orange stock" followed by the number you want to buy. You currently have 100 Orange stock.

>x redwood
Stock that you own that you can sell any number of. Type "sell redwood stock" followed by the number you want to sell or "puchase redwood stock" followed by the number you want to buy. You currently have 20 redwood stock.

>x backward
Stock that you own that you can sell any number of. Type "sell backward stock" followed by the number you want to sell or "puchase backward stock" followed by the number you want to buy. You currently have 100 backward stock.

>sell backward
I didn't understand that sentence.

>sell backward stock
I didn't understand that sentence.

>sell redwood stock
I didn't understand that sentence.

>sell backward stock 20
Now you have 80 backward stock and 3000 dollars.

>sell orange stock 20
Now you have 80 Orange stock and 7000 dollars.

>sell redwood stock 20
Now you have 0 redwood stock and 9000 dollars.

>sell backward stock 80
Now you have 0 backward stock and 21000 dollars.

>sell orange stock 80
Now you have 0 Orange stock and 37000 dollars.

The computer stops its insistant bleeping. Thank hevans that you managed to sell everything before they tanked any more. A voice booms out from a hidden speaker, "All employees come directly to the meeting room." You think you get to the meeting room by going south out of your office, west through the hallway into the elevator, down to the ground floor, and finally south from the lobby.

>s
Floor One Hallway

>x
What do you want to examine?

>w
You see nothing unexpected in that direction.

>w
Floor One Elevator

>down
You can't go that way.

>x
What do you want to examine?

>push ground floor button
You disinterestedly drum out a tatto on the posters wooden frame waiting for the elevator's door to ding open. Finally you step out into a bustling lobby.

Lobby
The lobby is bustling with activity. Dozens of former employees are being escorted off company ground carring their supplies in little cardboard boxes.

>talk to employees
You can't see any such thing.

>x employees
You can't see any such thing.

>s
You are one of the last employees to file into the Meeting room. It's jampacked containing more than 30 employees. Jonathan the senior offical in this branch of Merrill Lynch laboriously clambors on top of the table to adress everyone assembled. "I think most of you know why we are here but in case you've been asleep for the past five hours I'll recap. The DOW just droped 250 points in one day and our analyists predict it isn't going to get better for a very long time. Therefore, merrill Lynch will not be able to keep all of you. In fact we can only keep three. It shouldn't surrpise anyone that we are keeping Andrew who has been our most sucsessful trader for 2 years straight now. The other two are a bit more surrprising Philip and employee number 27?" Your Boss perks up and says, "That would be me sir." "Ah of course well you can stay. Everyone else has 3 hours to pack and leave." You can't afford to lose this job. It's the only thing paying your rent there must be some way to take your Boss's place after all it was you who saved his stocks. Perhapse there might be something in his office.

>talk to boss
You can't see any such thing.

>s
You can't go that way.

>n
Lobby
The lobby is bustling with activity. Dozens of former employees are being escorted off company ground carring their supplies in little cardboard boxes.

>e
Lobby Elevator

>push floor 1 button
Which do you mean, Floor Two Button, Floor One Button or Ground Floor Button?

>floor one button
You can't see any such thing.

>push floor one button
You disinterestedly drum out a tatto on the posters wooden frame waiting for the elevator's door to ding open. Finally you step out into a endless sea of cubicals.

Floor One Hallway

>e
Philip's Cubical
Philip's cubical while still small is significantly larger than yours. His computer is slightly less clunky than yours and has a stapler sitting next to it. Otherwise his office is mostly empty.

You can see Stapler here.

>w
Floor One Hallway

>n
Boss's Cubical
 Perhaps this room, if it can even be called a room, is the reason your Boss is constantly angry. Barely large enough for you to take a step in any direction everything is within easy arms reach. Not that there is much here an old computer sitting on a desk, a filling cabinet, and corded phone.

From day to day your Boss never seem change his appearence. He must own at least a dozen of the same set of plain clothes. Whenever he sees you his face turns a deep beetroot red and he seems to inflate.

>x computer
The computer is currently displaying your Boss's stock portofolio. It mainly consists of three stocks Orange, RedWood, and Backward. To your shock and dismay you realize that over the course of the last 10 minutes your Boss's portofolio has lost 10 percent equating to almost 13 million dollars. And the stocks" value are still plumiting. You'll have to act fast to save your clients. You try to remember how you Boss sold stocks. You think that he just typed sell or purchase, the stocks name, and the number of shares to buy or sell.

>x desk
You can't see any such thing.

>open filling cabinet
It seems to be locked.

>look under desk
You can't see any such thing.

>x file cabinet
You can't see any such thing.

>x filling cabinet
You see nothing special about Filling Cabinet.

>x filing cabinet
You can't see any such thing.

>talk to boss
You could say: 
[1]"Could I have the key for the cabinet?"

* * *

>1
"Could I have the key for the cabinet?" you ask. "Why should I give that?" your Boss responds.

>because
That's not a verb I recognise.

>could i please have the key for the cabinet
That's not a verb I recognise.

>talk to boss
You could say: [2]"Because I said so and thats the only reason you should need!"
[3]"I'm going to write one final report on how you saved your client's funds."

* * *

>open filling cabinet
It seems to be locked.

>i
You are carrying:
  Orange stock x 0
  backward stock x 0
  Redwood stock x 0

>talk to boss
You could say: [2]"Because I said so and thats the only reason you should need!"
[3]"I'm going to write one final report on how you saved your client's funds."

* * *

>x boss
You can't see any such thing.

>x phone
The phone is currently dormant with no messages and there isn't anyone you really want to call right now.

>x cabinet
This is where your Boss keeps all his records. Perhaps there may be something incriminating inside but you Boss has the key.

>sell orange stock 100
Now you have 0 Orange stock and 20000 dollars.

* * *

>w
Floor One Elevator
The company elevator is lined by decorative wodden panneling. A poster is a fixed to the wall directly across from the door and three buttons are just to the right of the door. They read Ground Floor, Floor One, and Floor Two. The exit is to the west.

>x button
Which do you mean, Ground Floor Button, Floor One Button or Floor Two Button?

>ground
The button has a large embroidered G on it.

* * *

>go north
You can't go that way.

* * *

>test
>--> No test scripts exist for this game.

* * *

>sell orange stock 1
Now you have 99 Orange stock and 300 dollars.

* * *

>x orange stock
Stock that you own that you can sell any number of. Type "sell orange stock" followed by the number you want to sell or "puchase orange stock" followed by the number you want to buy. You currently have 100 Orange stock. They cost 200 dollars a share.

* * *

>e
You can't go that way.

>sell orange stock
I didn't understand that sentence.

>sell orange stock 100
Now you have 0 Orange stock and 20000 dollars.

* * *

>sell redwood stock 20
Now you have 0 redwood stock and 37000 dollars.

The computer stops its insistant bleeping just as a voice booms out from a hidden speaker, "All employees come directly to the meeting room." You recall the meeting room is south out of your office, west through the hallway into the elevator, down to the ground floor, and finally south from the lobby.

>e
You can't go that way.

>s
Floor One Hallway
To the north is your Boss's cubical, to the east is Phillip's Cubical, and to the east if the elevator.

>w
Floor One Elevator
The company elevator is lined by decorative wodden panneling. A poster is a fixed to the wall directly across from the door and three buttons are just to the right of the door. They read Ground Floor, Floor One, and Floor Two. The exit is to the west.

>push ground
You disinterestedly drum out a tatto on the posters wooden frame waiting for the elevator's door to ding open. Finally you step out into a bustling lobby.

Lobby
The lobby is bustling with activity. Dozens of former employees are being escorted off company ground carring their supplies in little cardboard boxes. To the south is a meeting room and north is a cafe.

>talk to employees
You can't see any such thing.

>talk to former employes
You can't see any such thing.

>talk to former employees
You can't see any such thing.

>s
You are one of the last employees to file into the Meeting room. It's jampacked containing more than 30 employees. Jonathan the senior offical in this branch of Merrill Lynch laboriously clambors on top of the table to adress everyone assembled. "I think most of you know why we are here but in case you've been asleep for the past five hours I'll recap. The DOW just droped 250 points in one day and our analyists predict it isn't going to get better for a very long time. Therefore, merrill Lynch will not be able to keep all of you. He begins to rattle off a list of names and and fianlly employee number 27?" Your Boss perks up and says, "That would be me sir." "Ah of course well you can stay. Everyone else has 3 hours to pack and leave." You can't afford to lose this job. It's the only thing paying your rent there must be some way to take your Boss's place after all it was you who saved his stocks. Perhapse there might be something in his office.

Meeting Room
The room is dominated by a by a large glass table placed squarely in the center of the room. In the front of the room is a projector screen and back to the north is the lobby.

* * *

>x table
On top of the table is today's newspaper.

>take paper
You can't see any such thing.

>take newspaper
Taken.

>x newspaper
The newspaper is almost entirely devoted to the stock market dropping. The second page reads, "This is a not a minor event that's going to go away in a night. I expect orange's stock to keep dropping for the forseeable future."

>n
Lobby
The lobby is bustling with activity. Dozens of former employees are being escorted off company ground carring their supplies in little cardboard boxes. To the south is a meeting room and north is a cafe.

>e
Lobby Elevator
The company elevator is lined by decorative wodden panneling. A poster is a fixed to the wall directly across from the door and three buttons are just to the right of the door. They read Ground Floor, Floor One, and Floor Two. The exit is to the west.

>push floor two
You disinterestedly drum out a tatto on the posters wooden frame waiting for the elevator's door to ding open. Finally you step out into a expansive reception room.

Reception
This reception room is more lavish than any other portion of the building you have seen. Behind a marble desk sits an attendant. To the west is Jonathan Office.

You can see Attendant here.

>talk to attendant
You could say: You have nothing to say

>s
You can't go that way.

>e
You can't go that way.

>w
(first opening CEO Door)
It seems to be locked.

>e
You can't go that way.

>north
Floor Two Elevator
The company elevator is lined by decorative wodden panneling. A poster is a fixed to the wall directly across from the door and three buttons are just to the right of the door. They read Ground Floor, Floor One, and Floor Two. The exit is to the west.

>push floor one
You disinterestedly drum out a tatto on the posters wooden frame waiting for the elevator's door to ding open. Finally you step out into a endless sea of cubicals.

Floor One Hallway
To the north is your Boss's cubical, to the east is Phillip's Cubical, and to the east if the elevator.

>n
Boss's Cubical
 Perhaps this room, if it can even be called a room, is the reason your Boss is constantly angry. Barely large enough for you to take a step in any direction everything is within easy arms reach. Not that there is much here an old computer sitting on a desk, a filling cabinet, and corded phone. Your Boss is standing in the corner.

>n
You can't go that way.

>talk to boss
You could say: 
[1]"Could I have the key for the cabinet?"

* * *

>3
"I'm going to write one final report on how you saved your client's funds." you say. "Well... Alright." he responds handing you the key.

>l
Boss's Cubical
 Perhaps this room, if it can even be called a room, is the reason your Boss is constantly angry. Barely large enough for you to take a step in any direction everything is within easy arms reach. Not that there is much here an old computer sitting on a desk, a filling cabinet, and corded phone. Your Boss is standing in the corner.

>open filling cabinet
It seems to be locked.

>unlock filling cabinet
What do you want to unlock Filling Cabinet with?

* * *

>cabinet key
You unlock Filling Cabinet.

>i
You are carrying:
  Cabinet Key
  Today's Newspaper
  Orange stock x 0
  backward stock x 0
  Redwood stock x 0

>open filling cabinet
You open Filling Cabinet, revealing Notes.

>x notes
You knew your Boss would be to lazy to cover his tracks. Scattered throughout the various files are notes from conversations with the employes of numerous companies talking about products before they had been publicly announced. These are most definitely illegal and more than enough to get your Boss arrested but maybe there won't be a need for that perhaps you should talk to him.

* * *

>take notes
Taken.

>talk to boss
You could say: [4]"Hey, Boss look at this!"

* * *

>4
"Hey, Boss look at this!" you say gesturing with the notes. "Give those to me!" he shouts. "No. I'm not taking any more orders from you. Things go my way now. So this is what's going to happen. You are going to go to Jonathan and say that for personal reasons you have to resign." "Never." he spits. "Or would you prefer I go to the cops with this" you respond. "Fine." he said turning to leave. A few minutes later your phone begins to ring.

>answer phone
"Hello this is Jonathan. I understand that you are an intern at our company. Your former Boss just resigned and you are the one who best knows his clients and investments. So we are going to keep you on for five days in order to find a more sutiable replacement. Just try to keep your client's satisfied." Five days. You have five days to prove your worth to the company and stay on the payroll. After you have made the stock trades you want to for the day write "Go home" to advance to the next day. Some of the stock prices will change over the night.

>buy backward 300
You don't have enought money.

>buy backward 200
Now you have 200 backward stock and 7000 dollars.

>buy backward 40
Now you have 240 backward stock and 1000 dollars.

>buy backward 10
You don't have enought money.

>buy backward 5
Now you have 245 backward stock and 250 dollars.

>buy backward 1
Now you have 246 backward stock and 100 dollars.

>buy backward 1
You don't have enought money.

>buy redwood stock 1
Now you have 1 redwood stock and 0 dollars.

>go home
Another day ends as you lock in your final trades. You arrive back in the lobby after another long day.

Lobby
The lobby is bustling with activity. Dozens of former employees are being escorted off company ground carring their supplies in little cardboard boxes. To the south is a meeting room and north is a cafe.

>n
Cafe
This is where the less succsessful financial investors tend to meet their clients. 

You can see Client here.

>talk to client
You could say: 
[1]"Hello. How are you doing today?"
[2]"So why did you call me?"

* * *

>2
"So why did you call me?" you ask. "Ah, someone who gets straight to the point I like that. I want to know what you are planning to do with my money."

>talk to client
You could say: 
[3]"When the stock market is in turmoil like it is now you have the chance to make much more than if it were stable. I have acsess to numerous charts and projections created by our best analyists. Have no fear I will keep your money safe."
[4]"I'm going to make more of it."

>4
"I'm going to make more of it." you say. "I like that" she responds. "I think you are going to make a good broker so I'll give you some advice. One of my other brokers tells me that redwood is going to do well soon. Well that's all for now." She stands up and exits.

>l
Cafe
This is where the less succsessful financial investors tend to meet their clients.

>s
Lobby
The lobby is bustling with activity. Dozens of former employees are being escorted off company ground carring their supplies in little cardboard boxes. To the south is a meeting room and north is a cafe.

>e
Lobby Elevator
The company elevator is lined by decorative wodden panneling. A poster is a fixed to the wall directly across from the door and three buttons are just to the right of the door. They read Ground Floor, Floor One, and Floor Two. The exit is to the west.

>push floor one
You disinterestedly drum out a tatto on the posters wooden frame waiting for the elevator's door to ding open. Finally you step out into a endless sea of cubicals.

Floor One Hallway
To the north is your Boss's cubical, to the east is Phillip's Cubical, and to the east if the elevator.

>n
Boss's Cubical
Perhaps this room, if it can even be called a room, is the reason your Boss is constantly angry. Barely large enough for you to take a step in any direction everything is within easy arms reach. Not that there is much here an old computer sitting on a desk, a filling cabinet, and corded phone.

>i
You are carrying:
  Cabinet Key
  Notes
  Orange stock x 0
  backward stock x 246
  Redwood stock x 1

>sell backward stock 246
Now you have 0 backward stock and 49200 dollars.

>buy redwood stock 250
Now you have 251 redwood stock and 21700 dollars.

>buy redwood stock 250
You don't have enought money.

>buy redwood stock 100
Now you have 351 redwood stock and 10700 dollars.

>buy redwood stock 100
You don't have enought money.

>buy redwood stock 40
Now you have 391 redwood stock and 6300 dollars.

>buy redwood stock 20
Now you have 411 redwood stock and 4100 dollars.

>buy redwood stock 20
Now you have 431 redwood stock and 1900 dollars.

>buy redwood stock 10
Now you have 441 redwood stock and 800 dollars.

>buy redwood stock 5
Now you have 446 redwood stock and 250 dollars.

>buy redwood stock 2
Now you have 448 redwood stock and 30 dollars.

>s
Floor One Hallway
To the north is your Boss's cubical, to the east is Phillip's Cubical, and to the east if the elevator.

* * *

>e
Phillip's Cubical
Phillip's cubical while still small is significantly larger than yours. His computer is slightly less clunky than yours and has a stapler sitting next to it. Otherwise his office is mostly empty.

>x stapler
It's a standard utilitarian office stapler. There appears to be something sticking out from under the stapler.

>look under stapler
You find a yellow sticky note a fixed to the bottom of the stapler. It reads, "Pasword:
 abcd1234"

>x computer
 Phillip's Computer is currently locked with a password if you could find out what it is you could acsess his stocks.

>abcd1234
The computer gives a satisfying ding and you are logged in and able to see Phillip's Stocks.

>x philip's stocks
You can't see any such thing.

>x phillip's stocks
 Phillip is currently owns Phillip's Orange stock x 100 orange stocks, Phillip's Redwood stock x 20 Redwood Stocks, and Phillip's backward stock x 100 Backward. He has 0 dollars.

>go home
Another day ends as you lock in your final trades. You arrive back in the lobby after another long day.

Lobby
The lobby is bustling with activity. Dozens of former employees are being escorted off company ground carring their supplies in little cardboard boxes. To the south is a meeting room and north is a cafe.

>e
Lobby Elevator
The company elevator is lined by decorative wodden panneling. A poster is a fixed to the wall directly across from the door and three buttons are just to the right of the door. They read Ground Floor, Floor One, and Floor Two. The exit is to the west.

* * *

>push floor one
You disinterestedly drum out a tatto on the posters wooden frame waiting for the elevator's door to ding open. Finally you step out into a endless sea of cubicals.

Floor One Hallway
To the north is your Boss's cubical, to the east is Phillip's Cubical, and to the east if the elevator.

>n
Boss's Cubical
Perhaps this room, if it can even be called a room, is the reason your Boss is constantly angry. Barely large enough for you to take a step in any direction everything is within easy arms reach. Not that there is much here an old computer sitting on a desk, a filling cabinet, and corded phone.

You can see Call Card here.

* * *

>x call card
Financial Analyst for Hire 
 Contact us at "123-4567"

>call 123-4567
"Hello are you a financial analyst?" you ask. ""That is correct. For the small fee of 5,000 dollars I can give you my prediction. 
[1]"Ok"
[2]"No thanks"

>2
"No thanks" you say. "No problem. Call again if you change your mind." he responds.

>i
You are carrying:
  Cabinet Key
  Notes
  Orange stock x 0
  backward stock x 0
  Redwood stock x 448

>sell redwood stock 448
Now you have 0 redwood stock and 62750 dollars.

>call 123-4567
"Hello are you a financial analyst?" you ask. ""That is correct. For the small fee of 5,000 dollars I can give you my prediction. 
[1]"Ok"
[2]"No thanks"

* * *

>1
"Ok, I'll do it." you say. "My charts predict a rise in the worth of redwood." he responds.

>buy redwood 300
Now you have 300 redwood stock and 15750 dollars.

>buy redwood 300
You don't have enought money.

>buy redwood 100
Now you have 400 redwood stock and 1750 dollars.

>buy redwood 100
You don't have enought money.

>buy redwood 20
You don't have enought money.

>buy redwood 10
Now you have 410 redwood stock and 350 dollars.

>buy redwood 3
You don't have enought money.

>buy redwood 31
You don't have enought money.

>buy redwood 1
Now you have 411 redwood stock and 210 dollars.

>buy redwood 1
Now you have 412 redwood stock and 70 dollars.

>buy redwood 1
You don't have enought money.

>go home
Another day ends as you lock in your final trades. You arrive back in the lobby after another long day.

Lobby
The lobby is bustling with activity. Dozens of former employees are being escorted off company ground carring their supplies in little cardboard boxes. To the south is a meeting room and north is a cafe.

* * *

>e
Lobby Elevator
The company elevator is lined by decorative wodden panneling. A poster is a fixed to the wall directly across from the door and three buttons are just to the right of the door. They read Ground Floor, Floor One, and Floor Two. The exit is to the west.

>push floor 1
Which do you mean, Floor Two Button, Floor One Button or Ground Floor Button?

>push floor one
You disinterestedly drum out a tatto on the posters wooden frame waiting for the elevator's door to ding open. Finally you step out into a endless sea of cubicals.

Floor One Hallway
To the north is your Boss's cubical, to the east is Phillip's Cubical, and to the east if the elevator.

* * *

>n
Boss's Cubical
Perhaps this room, if it can even be called a room, is the reason your Boss is constantly angry. Barely large enough for you to take a step in any direction everything is within easy arms reach. Not that there is much here an old computer sitting on a desk, a filling cabinet, and corded phone.

You can see Call Card here.

>i
You are carrying:
  Cabinet Key
  Notes
  Orange stock x 0
  backward stock x 0
  Redwood stock x 412

>sell redwood 412
Now you have 0 redwood stock and 65990 dollars.

>buy orange stock 300
Now you have 300 Orange stock and 38990 dollars.

>buy orange stock 300
Now you have 600 Orange stock and 11990 dollars.

>buy orange stock 300
You don't have enought money.

>100
That's not a verb I recognise.

>buy orange stock 100
Now you have 700 Orange stock and 2990 dollars.

>buy orange stock 100
You don't have enought money.

>buy orange stock 10
Now you have 710 Orange stock and 2090 dollars.

* * *

>buy orange stock 10
Now you have 730 Orange stock and 290 dollars.

>buy orange stock 1
Now you have 731 Orange stock and 200 dollars.

* * *

>buy orange stock 1
Now you have 733 Orange stock and 20 dollars.

>go home
Another day ends as you lock in your final trades. You arrive back in the lobby after another long day.

Lobby
The lobby is bustling with activity. Dozens of former employees are being escorted off company ground carring their supplies in little cardboard boxes. To the south is a meeting room and north is a cafe.

* * *

>e
Lobby Elevator
The company elevator is lined by decorative wodden panneling. A poster is a fixed to the wall directly across from the door and three buttons are just to the right of the door. They read Ground Floor, Floor One, and Floor Two. The exit is to the west.

>push foor one
You can't see any such thing.

>push floor one
You disinterestedly drum out a tatto on the posters wooden frame waiting for the elevator's door to ding open. Finally you step out into a endless sea of cubicals.

Floor One Hallway
To the north is your Boss's cubical, to the east is Phillip's Cubical, and to the east if the elevator.

>n
As you enter your cubical your phone begins to ring.

>answer phone
"Who is this?" you ask. "It's Jonathan again. It has been four days. I would like you to try sell all the stocks you own so that I can asses your proformance." he responds

>i
You are carrying:
  Cabinet Key
  Notes
  Orange stock x 733
  backward stock x 0
  Redwood stock x 0

>sell orange stock 733
Now you have 0 Orange stock and 249240 dollars.

You phone begins to ring again.

>n
You can't go that way.

>s
Floor One Hallway
To the north is your Boss's cubical, to the east is Phillip's Cubical, and to the east if the elevator.

>n
As you enter your cubical your phone begins to ring.

>i
You are carrying:
  Cabinet Key
  Notes
  Orange stock x 0
  backward stock x 0
  Redwood stock x 0

>answer phone
"Who is this?" you ask. "It's Jonathan again. I would like to speak to you. Come to my office on the second floor." he says.

* * *

>e
Phillip's Cubical
Phillip's cubical while still small is significantly larger than yours. His computer is slightly less clunky than yours and has a stapler sitting next to it. Otherwise his office is mostly empty.

>w
Floor One Hallway
To the north is your Boss's cubical, to the east is Phillip's Cubical, and to the east if the elevator.

* * *

>w
Floor One Elevator
The company elevator is lined by decorative wodden panneling. A poster is a fixed to the wall directly across from the door and three buttons are just to the right of the door. They read Ground Floor, Floor One, and Floor Two. The exit is to the west.

>push floor two
You disinterestedly drum out a tatto on the posters wooden frame waiting for the elevator's door to ding open. Finally you step out into a expansive reception room.

Reception
This reception room is more lavish than any other portion of the building you have seen. Behind a marble desk sits an attendant. To the west is Jonathan Office.

You can see Attendant here.

>talk to attendant
You could say: 
[1]"May I speak Jonathan?"
[2]"Hello, how has your day been?"

* * *

>2
"Hello, how has your day been?" you ask. "Not great dear. Jonathan in recent years hasn't been very kind to me. And I fear that after these recent firings I'm going to be worked harder than ever."

>talk to attendant
You could say: [5]"Well perhaps he has grown complancent and it's time for him to be replaced."

>5
"Well perhaps he has grown complancent and it's time for him to be replaced." you say. "You know mabey you're right. I think you would make a much better Boss's than him. Take this card it has Jonathan's password on it see what you can do with that." Just then Jonthan exits his office saying, "I'll be back in a second. I just need to use the bathroom for a second."

>l
Reception
This reception room is more lavish than any other portion of the building you have seen. Behind a marble desk sits an attendant. To the west is Jonathan Office.

You can see Attendant here.

>w
CEO Office
 Jonathan posses a beautiful office overlooking a stunning view. In the middle of the room is a wooden desk with a computer sitting on top of it.

>x computer
 The newest top of the line computer. Humms gentally on the CEO's desk. The screen is currently obsucred by a password lock.

>i
You are carrying:
  Password Card
  Cabinet Key
  Notes
  Orange stock x 0
  backward stock x 0
  Redwood stock x 0

>x card
The card reads, "Jonathan is the best"

>type jonathan is the best
The computer dings and the lock screen disappears revealing the folder Pictures and his Imgur account. The imgur account reads "Put a photo in imgur to upload it."

>open pictures folder
That's already open.

>x pictures folder
This is where Jonathan keeps his Photos

In Pictures Folder is Obscene Photos.

>x obscene photos
You find a couple photos that you are sure Jonathan wouldn't be proud of.

>take photos
Taken.

>take obscene photos
You already have that.

>put photos in imgur
You put Obscene Photos into Imgur.

Just as you upload the photos and log out Jonathan re-enters the room.

>talk to jonathan
    *** "Hello sir." you say. "It's nice to see you. I have been looking at your progress over the past four days. I must say you have done very well. I'm impressed. I think you will make a fine broker better than we could hire right now. We are keeping you on." Just as Jonathan finished talking his cellphone started to ring. "Excuse me for a moment. Hello. Yes this is Jonathan. What! No! I never did that! Here he is." He hands the phone to you. "Hello I'm Andrew head of Merrill Lynch's Board of Directors. Jonathan uploaded some obscene photos and the media are having field day. So he is going to be fired to save face. We the board has decided to appoint you acting CEO." ***

Would you like to RESTART, RESTORE a saved game, QUIT or UNDO the last command?