"Hurry up! I thought I asked you for those copies five minutes ago and this coffee is cold get me another." You have had this job for less than two days and already contimplated "acidently" pushing your Boss out a window 12 times. "Hell, Michael was a better assitant than you are and he couldn't tell the differance between a pen and pencil." Your jaw begins to ache from holding tightly clenched shut to contain the fowl stream of profanity that you would otherwise end up hurrling at your boss. Standing up from the file you've been sorting you turn to your boss and manage to say, "Alright I'm going to make copies and get your coffee i'll be back soon." His face turns and even darker shade of red as he shouts, "No! You stay here I don't want to have to wait another hour for my coffee."

BlueChipDown
An Interactive Fiction by Jonathan Nakagawa
Release 1 / Serial number 141024 / Inform 7 build 6L38 (I6/v6.33 lib 6/12N) SD

Boss's Cubical
 Perhaps this room, if it can even be called a room, is the reason your Boss is constantly angry. Barely large enough for you to take a step in any direction everything is within easy arms reach. Not that there is much here an old computer sitting on a desk, a filling cabinet, and corded phone. The computer is insistantly beeping. 

From day to day your Boss never seem change his appearence. He must own at least a dozen of the same set of plain clothes. Whenever he sees you his face turns a deep beetroot red and he seems to inflate.

You can also see Filling Cabinet (closed) here.

>i
You are carrying:
  Orange stock x 100
  backward stock x 100
  Redwood stock x 20
  Philip's Orange stock x 100
  Philip's backward stock x 100
  Philip's Redwood stock x 20

>sell orange stock 50
Now you have 50 Orange stock and 10000 dollars.

>i
You are carrying:
  Orange stock x 50
  backward stock x 100
  Redwood stock x 20
  Cabinet Key

>buy redwood 40
Now you have 60 redwood stock and 6000 dollars.

>sell 50 orange stock
You can't use multiple objects with that verb.

>sell orange stock 50
Now you have 0 Orange stock and 16000 dollars.

>sell backward stock 100
Now you have 0 backward stock and 31000 dollars.

>sell redwood stock 50
Now you have 10 redwood stock and 36000 dollars.

>sell redwood stock 10
Now you have 0 redwood stock and 37000 dollars.

The computer stops its insistant bleeping. Thank hevans that you managed to sell everything before they tanked any more.

* * *

>i
You are carrying:
  Orange stock x 100
  backward stock x 100
  Redwood stock x 20
  Philip's Orange stock x 100
  Philip's backward stock x 100
  Philip's Redwood stock x 20

>sell orange stock 100
Now you have 0 Orange stock and 20000 dollars.

* * *

>sell backward stock 100
Now you have 0 backward stock and 35000 dollars.

>buy orange stock 100
Now you have 100 Orange stock and 15000 dollars.

>sell orange stock 1000
You don't have that many stock to sell. You have 100 Orange stock.

>sell orange stock 100
Now you have 0 Orange stock and 35000 dollars.

>sell redwood stock 20
Now you have 0 redwood stock and 37000 dollars.

The computer stops its insistant bleeping. Thank hevans that you managed to sell everything before they tanked any more.

>s
You can't leave yet you need to first see what's up with the computer.

* * *

>s
Floor One Hallway

>w
Floor One Elevator

>push ground button
You disinterestedly drum out a tatto on the posters wooden frame waiting for the elevator's door to ding open. Finally you step out into a bustling lobby.

Lobby
The lobby is bustling with activity. Dozens of former employees are being escorted off company ground carring their supplies in little cardboard boxes.

>s
Meeting Room

* * *

>sell backward stock 100
Now you have 0 backward stock and 35000 dollars.

>sell redwoodstock 20
You can't see any such thing.

>sell redwood stock 20
Now you have 0 redwood stock and 37000 dollars.

The computer stops its insistant bleeping. Thank hevans that you managed to sell everything before they tanked any more. A voice booms out from a hidden speaker, "All employees come directly to the meeting room." You think you get to the meeting room by going south out of your office, west through the hallway into the elevator, down to the ground floor, and finally south from the lobby.

* * *

>w
Floor One Elevator

>push ground floor button
You disinterestedly drum out a tatto on the posters wooden frame waiting for the elevator's door to ding open. Finally you step out into a bustling lobby.

Lobby
The lobby is bustling with activity. Dozens of former employees are being escorted off company ground carring their supplies in little cardboard boxes.

>s
You are one of the last employees to file into the Meeting room. It's jampacked containing more than 30 employees. Jonathan the senior offical in this branch of Merrill Lynch laboriously clambors on top of the table to adress everyone assembled. "I think most of you know why we are here but in case you've been asleep for the past five hours I'll recap. The DOW just droped 250 points in one day and our analyists predict it isn't going to get better for a very long time. Therefore, merrill Lynch will not be able to keep all of you. In fact we can only keep three. It shouldn't surrpise anyone that we are keeping Andrew who has been our most sucsessful trader for 2 years straight now. The other two are a bit more surrprising Philip and employee number 27?" Your Boss perks up and says, "That would be me sir." "Ah of course well you can stay. Everyone else has 3 hours to pack and leave." You can't afford to lose this job. It's the only thing paying your rent there must be some way to take your Boss's place after all it was you who saved his stocks. Perhapse there might be something in his office.

>n
Lobby
The lobby is bustling with activity. Dozens of former employees are being escorted off company ground carring their supplies in little cardboard boxes.

* * *

>e
Lobby Elevator

>push floor one button
You disinterestedly drum out a tatto on the posters wooden frame waiting for the elevator's door to ding open. Finally you step out into a endless sea of cubicals.

Floor One Hallway

>e
Philip's Cubical
You can see Stapler here.

>w
Floor One Hallway

>n
Boss's Cubical
 Perhaps this room, if it can even be called a room, is the reason your Boss is constantly angry. Barely large enough for you to take a step in any direction everything is within easy arms reach. Not that there is much here an old computer sitting on a desk, a filling cabinet, and corded phone.

From day to day your Boss never seem change his appearence. He must own at least a dozen of the same set of plain clothes. Whenever he sees you his face turns a deep beetroot red and he seems to inflate.

You can also see Filling Cabinet (closed) here.

>talk to boss
You could say: 
"Could I have the key for the cabinet?"
"Because I said so and thats the only reason you should need!"
"I'm going to write one final report on how you saved your client's funds."

* * *

>sell orange stock 100
Now you have 0 Orange stock and 20000 dollars.

>sell redwood stock 20
Now you have 0 redwood stock and 22000 dollars.

>sell backward stock 100
Now you have 0 backward stock and 37000 dollars.

The computer stops its insistant bleeping. Thank hevans that you managed to sell everything before they tanked any more.

>s
Floor One Hallway

>buy orange stock 370
You don't have enought money.

>buy orange stock 100
You don't have enought money.

>n
Boss's Cubical
 Perhaps this room, if it can even be called a room, is the reason your Boss is constantly angry. Barely large enough for you to take a step in any direction everything is within easy arms reach. Not that there is much here an old computer sitting on a desk, a filling cabinet, and corded phone.

From day to day your Boss never seem change his appearence. He must own at least a dozen of the same set of plain clothes. Whenever he sees you his face turns a deep beetroot red and he seems to inflate.

You can also see Filling Cabinet (closed) here.

>buy orange stock 1
You don't have enought money.

>i
You are carrying:
  Orange stock x 942
  backward stock x 0
  Redwood stock x 0
  Cabinet Key

>buy orange stock 10
You don't have enought money.

>i
You are carrying:
  Orange stock x 962
  backward stock x 0
  Redwood stock x 0
  Cabinet Key

>s
Floor One Hallway

* * *

>i
You are carrying:
  Orange stock x 962
  backward stock x 0
  Redwood stock x 0
  Cabinet Key

* * *

>open cabinet
(cabinet key)
It isn't something you can open.

>unlock cabinet
(cabinet key with cabinet key)
That doesn't seem to be something you can unlock.

* * *

>unlock cabinet
(with Cabinet Key)
That doesn't seem to be something you can unlock.

>open cabinet
It isn't something you can open.

>unlock cabinet
(cabinet key with cabinet key)
That doesn't seem to be something you can unlock.

>ulock cabinet with cabinet key
I didn't understand that number.

* * *

>buy orange stock 10
You don't have enought money.

>i
You are carrying:
  Orange stock x 120
  backward stock x 100
  Redwood stock x 20
  Philip's Orange stock x 100
  Philip's backward stock x 100
  Philip's Redwood stock x 20

* * *

>Sell orange
You need to sit down first.

* * *

>x redwood stock
Stock that you own that you can sell any number of. Type "sell redwood stock" followed by the number you want to sell or "puchase redwood stock" followed by the number you want to buy. You currently have 20 redwood stock.

* * *

>unlock filling cabinet
(with Cabinet Key)
You unlock Filling Cabinet.

>open cabinet
(Cabinet Key)
It isn't something you can open.

>open filling cabinet
You open Filling Cabinet.

* * *

>talk to boss
You could say:

* * *

>1
"Could I have the key for the cabinet?" you ask. "Why should I give that?" your Boss responds.

>1
No such option is available.

>2
*** Run-time problem P23: Attempt to look up a non-existent entry at column 2, row 2 of the table 'Table of Black Mail Queries'.

* * *

>undo
Boss's Cubical
[Previous turn undone.]

>3
"I'm going to write one final report on how you saved your client's funds." you say. "Well... Alright." he responds handing you the key.

* * *

>1
"Could I have the key for the cabinet?" you ask. "Why should I give that?" your Boss responds.

>4
No such option is available.

>talk to boss
You could say: 
[1]: hello how are you?

>1
No such option is available.

* * *

>4
No such option is available.

>5
No such option is available.

>1
No such option is available.

* * *

>1
"Could I have the key for the cabinet?" you ask. "Why should I give that?" your Boss responds.

>2
No such option is available.

>1
No such option is available.

>2
No such option is available.

>3
No such option is available.

>0
No such option is available.

* * *

>x orange stock
You own 100 shares